#############################
#...1.............G......5..#
#####...E...................#
#...#.......####.......######
#..##......6...#..##...#..4.#
#....G.....E...#..3#........#
#..............E.###...######
#........#######............#
#......2E......#.#.......H..#
#.............7#.#....E.....#
#############################